aquila	akuila
fa	ˈfa
abate	aˈbate
in	in
zero	ˈdzɛro
parole	paɾɔle
seme	ˈseme
rape	ˈrape
sabato	ˈsabato
libero	ˈlibero
aria	ˈarja
guerra	ˈɡwɛr.ra
relegate	re.leˈɡa.te
austria	ˈaustrja
ci	tʃi
bulgaria	bulɡaˈri.a
indonesia	indoˈnɛzja
romania	romaˈnia
slovenia	zloˈvɛnja
venezuela	venedˈdzwela
computer	komˈpjuter
macedonia	matʃeˈdɔnja
dare	ˈdare
cane	ˈkane
tempo	ˈtempo
secondo	seˈkondo
zebra	ˈdzɛːbra
qua	kwa
abaco	ˈabako
non	non
male	ˈmaː.le
remote	reˈmɔː.t̪e
carne	ˈkarne
fortune	forˈt̪uː.ne
grazie	ˈɡrattsje
cicisbeo	tʃi.tʃi.ˈzbɛ.o
burro	ˈbur.ro
me	me
pizza	ˈpit.tsa
sale	ˈsale
come	ˈkome
dove	ˈdove
business	ˈbiznis
card	kard̪
albero	ˈalbero
e	e
africa	ˈafrika
oceania	otʃeˈanja
asia	ˈazja
mare	ˈmare
hawaii	a.ˈwai
essere	ˈɛs.se.re
lui	ˈlui
ha	a
uno	ˈuno
due	ˈdue
tre	t̪re
quattro	ˈkwattro
cinque	ˈtʃinkwe
otto	ˈɔt.to
undici	ˈunditʃi
tredici	ˈtreditʃi
quattordici	kwatˈtorditʃi
quindici	ˈkwinditʃi
acido	ˈaː.tʃi.d̪o
musica	ˈmu.zi.ka
colore	koˈlore
con	kon
iota	ˈjɔːta
madrid	maˈdrid
casa	ˈkasa
pesce	ˈpeʃʃe
osso	ˈɔsso
bici	ˈbitʃi
cioccolata	tʃok.koˈlaː.ta
neon	ˈnɛ.on
kayak	ka.ˈjak
parigi	pa.ˈri.dʒi
se	se
ho	ɔ
sole	ˈsole
tu	t̪u
utopia	utoːpja
noi	ˈnoi
privacy	ˈpraivasi
algebra	al.d͡ʒɛ.ˈbra
testa	ˈtɛsta
gnu	ˈɲu
florida	ˈflɔ.ri.da
acute	aˈkute
zoo	ˈdzɔ.o
cola	ˈkoː.la
verona	veˈroːna
zanzibar	dzandzibar
dodici	ˈdoditʃi
fate	ˈfaː.t̪e
valle d'aosta	ˌva.lːe.daˈɔs.ta
campania	kamˈpaː.nja
friuli-venezia giulia	ˈfrjuli veˈnɛttsja ˈdʒulja
ancona	aŋˈkona
bologna	boˈloɲɲa
brescia	ˈbreʃːa
pavia	paˈviːa
ravenna	raˈvenna
progetto	proˈdʒɛtto
ser	sːɛ.r
gabardine	ɡa.barˈd̪iː.ne
maestoso	maeˈstozo
fare	ˈfaː.re
papa	ˈpaː.pa
zenit	ˈdzɛnit
grate	ˈɡrate
sumo	ˈsu.mo
primavera	primaˈvɛra
secreto	seˈkreto
creole	ˈkrɛːole
curio	ˈkurjo
italiano	it̪aˈljaː.no
cembalo	ˈtʃembalo
lasagna	laˈzaɲːa
formula	ˈfɔrmula
vita	ˈvita
volo	ˈvo.lo
via	ˈvia
vespa	ˈvɛspa
uovo	ˈwɔvo
zona	ˈdzɔːna
mano	ˈmaːno
pugno	ˈpuɲɲo
persia	ˈpɛrsja
automobile	au.to.ˈmɔ.bi.le
ratto	ˈrat̪t̪o
verme	ˈvɛrme
hai	ˈai̯
hanno	ˈanno
pero	ˈpe.ɾo
corda	ˈkɔrda
piuma	ˈpjuma
zanzara	d͡zanˈd͡zara
luna	ˈluː.na
lago	ˈlaɡo
largo	ˈlarɡo
leggero	ledˈdʒɛro
lingua	ˈliŋ.ɡwa
acqua	ˈakːwa
febbraio	febˈbraː.jo
libreria	li.breˈriː.a
martedì	mar.teˈdi
marzo	ˈmar.tso
mezzo	ˈmɛd.dz͡o
mercoledì	mer.ko.leˈdi
montagna	monˈtaɲɲa
neve	ˈneve
nuotare	nwoˈtare
sono	ˈsoː.no
oggi	ˈɔd.dʒi
oca	ˈɔka
ale	ˈa.le
influenza	iɱ.fluˈɛn.t̪s̪͡a
numero	ˈnu.me.ro
sapere	saˈpeː.re
passive	pas.ˈsi.ve
versatile	verˈsaː.t̪i.le
vento	ˈvɛnto
volare	voˈlare
vino	ˈvino
vipera	ˈvipera
uomo	ˈwɔmo
cadere	kaˈdere
castello	kaˈst̪ɛl.lo
chitarra	kiˈt̪ar.ra
chiodo	ˈkjɔdo
jolly	ˈdʒolli
narrative	nar.raˈt̪iː.ve
coda	ˈkoda
stare	ˈsta.re
fronte	ˈfron.t̪e
panna	ˈpan.na
ossigeno	osˈsidʒeno
terzo	ˈtɛrt͡so
quinto	ˈkwinto
settimo	ˈsɛttimo
gatto	ˈɡat̪.t̪o
ghiaccio	ˈɡjattʃo
ciao	ˈtʃaː.o
iarda	ˈjar.d̪a
e pur si muove	epˈpur si ˈmwɔː.ve
stage	staʒ
bue	ˈbu.e
buoi	ˈbwɔi̯
bruschetta	bruˈsket.ta
maestà	maeˈsta
fame	ˈfaː.me
-ese	ˈe.ze
pace	ˈpatʃe
padre	ˈpadre
pioggia	ˈpjɔddʒa
piovere	ˈpjɔvere
pelle	ˈpɛlle
che	ˈke
banca	ˈbaŋ.ka
italia	iˈtalja
statua	ˈstatwa
aceto	aˈt͡ʃeto
caos	ˈka.os
ala	ˈala
stella	ˈstella
cina	ˈtʃina
zucca	ˈtsukka
imbroglio	imˈbrɔʎʎo
minnesota	min.ne.ˈzɔ.ta
alba	ˈalba
albo	ˈal.bo
terra	ˈtɛr.ra
cantare	kanˈt̪are
dormire	dorˈmire
gente	ˈdʒɛnte
bellezza	belˈlet.tsa
bene	ˈbɛː.ne
bocca	ˈbokka
bicicletta	bi.t͡ʃiˈkle.tːa
bellissimo	belˈlis.si.mo
bello	ˈbɛl.lo
gelato	dʒ͡eˈlaː.t̪o
gennaio	dʒenˈnajo
geometria	d͡ʒeomeˈtria
giacca	ˈdʒ͡ak.̚ka
gli	ʎi
cuore	ˈkwɔre
breve	ˈbrɛːve
diciannove	ditʃanˈnɔve
è	ɛ
occhio	ˈɔkːjo
anno	ˈanno
fanno	ˈfan.no
le	le
pierre	piˈɛrre
immolate	im.moˈlaː.t̪e
facile	ˈfaː.tʃi.le
gerusalemme	dʒeruzaˈlemme
taxi	ˈtaksi
trireme	tri.ˈrɛ.me
moglie	ˈmo.ʎːe
va	va
dolce	ˈdol.tʃe
mese	ˈmeː.se
aprile	aˈpriː.le
luglio	ˈluʎʎo
maggio	ˈmad.dʒo
bianco	ˈbjanko
corno	ˈkɔrno
d'	d‿
spaghetti	spaˈɡet.ti
clone	ˈklo.ne
cioccolato	tʃok.koˈlaː.to
angelo	anˈd͡ʒɛlɔ
madre	ˈmadre
fresco	ˈfreː.sko
supreme	su.ˈprɛ.me
vanga	ˈvanɡa
legno	ˈleɲɲo
aurora	auˈrɔra
dire	ˈd̪iː.re
mangiare	man.ˈdʒa.re
vedere	veˈdere
là	la
loro	ˈloro
ginocchio	dʒiˈnɔkkjo
lunedì	lu.neˈdi
abbiamo	abˈbjamo
avete	aˈvete
puglia	ˈpuʎʎa
ogni	ˈoɲːi
cielo	ˈtʃɛlo
recede	reˈtʃɛde
eureka	ˈɛu̯.re.ka
circa	ˈtʃir.ka
cena	ˈtʃena
geisha	ˈɡɛiʃʃa
europa	euˈrɔpa
antimonio	antiˈmɔnjo
capo	ˈkapo
cove	ˈko.ve
dote	ˈdɔ.te
gala	ˈɡaː.la
lacuna	laˈkuna
schema	ˈskɛ.ma
vie	ˈviː.e
volta	ˈvɔlta
fascia	ˈfaʃ.ʃa
saliva	saˈliː.va
insalata	in.saˈlaː.t̪a
scimmia	ˈʃimmja
fermata	ferˈmata
piccolo	ˈpikːolo
khat	kat
siamo	ˈsjamo
sia	ˈsi.a
ebreo	e.ˈbrɛ.o
pianta	ˈpjan.ta
sapore	sa.ˈpo.re
uragano	uraˈɡano
insieme	inˈsjɛme
firenze	fiˈrɛntse
orecchio	ɔˈrekkjo
giorgio	ˈdʒordʒo
grecia	ˈɡrɛtʃa
ponte	ˈpon.te
notte	ˈnɔtte
novembre	noˈvɛm.bre
nuovo	ˈnwɔvo
suono	ˈswɔː.no
sabbia	ˈsabbja
stupido	ˈst̪uː.pi.d̪o
onore	o.ˈno.re
eroe	e.ˈrɔ.e
gamba	ˈɡamba
piede	ˈpjɛde
fuoco	ˈfwɔko
qui	kwi
miele	ˈmjɛ.le
temere	teˈmere
domenica	d̪oˈmeː.ni.ka
quando	ˈkwando
unghia	ˈunɡja
dente	ˈdɛnte
spesso	ˈspesso
radice	raˈditʃe
fiume	ˈfjume
giorno	ˈdʒorno
tedesco	teˈdesko
tutto	ˈtutto
tirare	t̪iˈrare
dolore	do.ˈlo.re
strada	ˈstrada
valere	va'le.re
marito	maˈrito
pomodoro	po.moˈdɔː.ro
creme	ˈkrɛ.me
iberia	iˈbɛrja
venire	veˈnire
castellano	kastelˈlano
alfabeto	al.fa.ˈbɛ.to
morire	moˈrire
giocare	dʒoˈkare
attore	at.ˈto.re
muro	ˈmu.ro
lancia	ˈlant͡ʃa
spagnolo	spaˈɲɲɔ.lo
pesto	ˈpesto
agosto	aˈɡoː.sto
zagara	ˈdzaɡara
zazzera	ˈtsattsera
tunnel	ˈt̪un.nel
zecca	ˈtsekka
zeppa	ˈtseppa
zinco	ˈtsiŋko
zirlo	ˈt͡sirlo
vicino	viˈtʃino
zolla	ˈtsɔlla
invidia	inˈvidja
parlare	par.ˈla.re
zucchero	ˈdzukːero
zuffa	ˈtsuffa
andrea	anˈd̪rɛː.a
solo	ˈso.lo
abbracciare	abːraˈtːʃaːre
ora	ˈo.ra
abusare	abuˈzare
salita	saˈlita
città	t͡ʃit.ˈta
cucinare	kutʃiˈnare
aglio	ˈaʎʎo
perché	perˈke
fetta	ˈfet.ta
acciaio	atˈtʃajo
ananas	ˈa.na.nas
abbandono	abbanˈdono
abbigliamento	abbiʎʎaˈmento
questo	ˈkwe.sto
quello	ˈkwello
abito	ˈabito
s-	s
lanciare	lanˈtʃare
grande	ˈɡrande
natale	na.ˈta.le
bambino	bamˈbino
barbiere	barˈbjɛ.re
figlio	ˈfiʎːo
quaggiù	kwaˈdd͡ʒu
qualcosa	kwal.ˈkɔza
qualcuno	kwal.ˈkuno
tagliare	taʎˈʎare
donna	ˈdɔnna
serpente	serˈpɛnte
uccidere	utˈtʃidere
cinema	ˈtʃiː.ne.ma
acero	ˈatʃero
orca	ˈɔrka
altro	ˈaltro
lungo	ˈlunɡo
animale	aniˈmale
collo	ˈkɔllo
udire	uˈdire
vivere	ˈvivere
ridere	ˈridere
sinistra	siˈnistra
lontano	lonˈtano
freddo	ˈfreddo
pietra	ˈpjɛtra
macchia	ˈmak.kja
nuvola	ˈnuvola
piacere	pjaˈtʃere
pericolo	pe.ˈri.ko.lo
ultimo	ˈultimo
pieno	ˈpjɛno
conoscere	koˈnoʃʃere
goccia	ˈɡottʃa
cucire	kuˈtʃire
quasi	ˈkwaː.zi
quasi-	ˈkwaː.zi
hawaiano	a.wa.ˈja.no
struggere	ˈstrudd͡ʒere
nero	ˈnero
crudele	kru.ˈdɛ.le
naso	ˈnaso
salmone	salˈmone
scienza	ˈʃɛn.ts͡a
stretto	ˈstretːo
ieri	ˈjɛː.ri
isola	ˈiː.zo.la
spingere	ˈspindʒere
caldo	ˈkaldo
corse	ˈkorse
giro	ˈdʒi.ro
chino	ˈkino
pena	ˈpena
casino	kaˈziː.no
epigone	eˈpiːɡɔne
domani	doˈmaː.ni
papabile	pa.paˈbi.le
bile	ˈbile
amore	a.ˈmo.re
meraviglioso	meraviʎˈʎozo
oro	ˈɔro
spagna	ˈspa.ɲɲa
europeo	eu.ro.ˈpɛ.o
birra	ˈbir.ra
bireme	bi.ˈrɛ.me
c'è	ˈtʃɛ
cognoscente	koɲoˈʃɛnte
nota bene	ˈnɔta ˈbɛne
verde	ˈver.de
varicose	va.riˈko.se
giovedì	dʒo.veˈdi
venerdì	ve.nerˈdi
rete	ˈrete
famiglia	faˈmiʎʎa
caffè	kafˈfɛ
uranio	uˈranjo
urano	uˈrano
broccoli	ˈbrɔk.̚ko.li
gioia	ˈdʒɔja
respirare	respiˈrare
prima	ˈpriː.ma
pesante	peˈsante
schiavo	ˈskjavo
schiavitù	skjaviˈtu
sodio	ˈsɔdjo
cloro	ˈklɔro
cromo	ˈkrɔmo
cobalto	koˈbalto
selenio	seˈlɛnjo
bromo	ˈbrɔmo
rubidio	ruˈbidjo
niobio	ˈnjɔbjo
rutenio	ruˈtɛnjo
cadmio	ˈkadmjo
indio	ˈindjo
cesio	ˈtʃɛzjo
tantalio	tanˈtaljo
renio	ˈrɛnjo
osmio	ˈɔzmjo
iridio	iˈridjo
platino	ˈplatino
mercurio	merˈkurjo
astato	aˈstato
francio	ˈfrantʃo
praseodimio	prazeoˈdimjo
neodimio	neoˈdimjo
europio	euˈrɔpjo
gadolinio	ɡadoˈlinjo
terbio	ˈtɛrbjo
erbio	ˈɛrbjo
tulio	ˈtuljo
torio	ˈtɔrjo
plutonio	pluˈtɔnjo
americio	ameˈrit͡ʃo
mendelevio	mendeˈlɛvjo
identikit	identiˈkit
corto	ˈkorto
odio	ˈɔdjo
geografia	dʒeoɡraˈfi.a
evidente	eviˈdɛnte
gusto	ˈɡuː.st̪o
bisogno	biˈzoɲ.ɲo
entro	ˈentro
soldo	ˈsɔldo
centimetro	tʃen.ˈti.me.tro
amico	a.ˈmi.ko
grigie	ˈgridʒe
favore	fa.ˈvo.re
creare	kreˈare
cieco	ˈtʃɛko
fuggire	fudˈdʒire
frutta	ˈfrutta
frigorifero	friɡoˈrifero
valle	ˈva.lːe
chiesa	ˈkjɛza
già	ˈdʒa
egitto	eˈdʒit.to
finestra	fiˈnɛː.st̪ra
finisse	fiˈnisse
ridicolo	ri.ˈdi.ko.lo
principe	ˈprin.tʃi.pe
atmosfera	atmosˈfɛra
fortuna	forˈt̪uː.na
forbici	ˈfɔrbitʃi
poso	ˈpɔso
traduce	traˈdutʃe
budget	ˈbaddʒet
difese	diˈfese
allora	alˈlora
avvenimento	avveniˈmento
offese	ofˈfese
beve	ˈbeve
pronunciare	pronunˈtʃare
bis	bis
sorriso	sorˈriso
anche	ˈaŋ.ke
germania	dʒerˈmanja
svizzera	ˈzvittsera
così	koˈsi
elio	ˈɛ.ljo
saturno	saˈturno
cripto	ˈkripto
sedere	seˈdere
giallo	ˈdʒ͡al.lo
quinta	ˈkwinta
gnocchi	ˈɲɔk.ki
microonda	mikroˈonda
nazione	natːˈsjoːne
aggettivo	addʒetˈtivo
farmacia	farmaˈtʃi.a
medicina	mediˈt͡ʃina
abbecedario	ab.be.tʃe.ˈda.rjo
ritorno	riˈtorno
portogallo	por.t̪oˈɡal.̚lo
belgio	ˈbɛldʒo
venezia	veˈnɛttsja
regalo	re.ˈɡaː.lo
finirai	finiˈrai
gnocca	ˈɲɔkka
a	a
baviera	baˈvjeːra
elio	ˈɛ.ljo
terra	ˈtɛrra
adele	əˈdɛlɛ
continuo	konˈtinwo
poco	ˈpɔko
secco	ˈsekko
reo	ˈrɛ.o
sera	ˈseː.ra
faccio	ˈfat.tʃ͡o
boh	ɓɔʔ
sci	ˈʃi
diastole	diˈastole
formaggio	for.ˈmad.dʒo
ciliegia	tʃ͡iˈljɛː.dʒ͡a
enclave	eŋˈklave
prodotto	proˈdotto
produco	proˈduko
produci	proˈdut͡ʃi
sentisse	senˈtisse
rapa	ˈrapa
pigmeo	piɡ.ˈmɛ.o
seta	ˈseː.t̪a
scherzo	ˈskertso
buono	ˈbwɔː.no
sorte	ˈsɔrte
nota	ˈnɔː.t̪a
giuseppe	dʒuˈzɛppe
amica	a.ˈmi.ka
biglietto	biʎˈʎɛtto
fuochi	ˈfwoki
guido	ˈɡwi.do
donne	ˈdɔn.ne
parola	paˈɾɔla
provincia	pro.ˈvin.t͡ʃa
spiaggia	ˈspjaddʒa
frase	fra.ze
grillo	ˈɡril.lo
mausoleo	mau.zo.ˈlɛ.o
glicerina	ɡli.tʃe.ˈri.na
glicine	ˈɡlitʃine
intestino	intesˈtino
gliela	ˈʎela
gliele	ˈʎele
glieli	ˈʎeli
glielo	ˈʎelo
gliene	ˈʎene
foro	ˈfoːro
idem	ˈidem
chiaro	'kja.ro
confermare	koŋ.fer.ˈma.re
stele	ˈstɛ.le
linguistica	linˈɡwistika
dipsomania	dip.so.maˈni.a
fermare	fɛr.ˈma.re
difficile	difˈfitʃile
biella	ˈbjɛlla
vecchio	ˈvɛkkjo
lotto	ˈlɔtto
esperanto	e.speˈran.to
articolo	ar.ˈti.ko.lo
tiramisù	ˌtiramiˈsu
medusa	meˈduza
cellula	ˈt͡ʃɛllula
definizione	definiˈtsjone
conosco	koˈnosko
sete	ˈseː.t̪e
ginevra	dʒiˈneːvra
giardino	dʒ͡arˈd̪iː.no
mancia	ˈmantʃa
oche	ˈɔke
stucco	ˈstukko
precipitevolissimevolmente	pre.tʃi.pi.te.voˌlis.si.me.volˈmen.te
natale	na.ˈta.le
tarantella	taranˈtɛlːa
ragno	ˈraɲɲo
corvo	ˈkɔrvo
quadrireme	kwa.dri.ˈrɛ.me
selva	ˈselva
saltimbanco	saltimˈbanko
mamma mia	ˈmamma ˈmia
tipo	ˈti.po
lasagne	laˈzaɲːe
pistola	piˈst̪ɔː.la
piscina	piʃˈʃina
foci	ˈfoː.tʃi
diamine	ˈdjamine
amaro	a.ˈma.ro
biga	ˈbiɡa
pomeriggio	pomeˈriddʒo
nebbia	ˈnebbja
sere	ˈseː.re
gelare	dʒeˈlare
fai	ˈfai
erba	ˈɛrba
paglia	ˈpaʎʎa
cera	ˈtʃera
cui	ˈkuj
nudo	ˈnudo
camminare	kammiˈnare
schiuma	ˈskjuma
torre	ˈtorre
sapienza	sa.ˈpjɛn.tsa
rotacismo	rotaˈtʃizmo
abbiccì	ab.bitˈtʃi
alessandra	alesˈsandra
alessandro	alesˈsandro
breccia	ˈbrɛttʃa
lise	li.se
frittata	fritˈtaː.ta
bine	ˈbine
elione	e.ˈljo.ne
cavallo	kaˈvalːo
berillo	be.ˈrilː.o
beatrice	ˌbeaˈtritʃɛ
fluoruro	flwoˈruro
solfidrico	sol.fi.dri.ko
giugno	ˈdʒuɲ.ɲo
fango	ˈfaŋɡo
tomba	ˈtomba
giovanni	dʒoˈvanni
baie	baje
pizzaiolo	pit.tsa.ˈjɔ.lo
osteria	osteˈria
bagna càuda	baɲaˈkɑʊda
pancia	ˈpantʃa
fagiolo	fa.ˈdʒɔ.lo
madonna	maˈdɔ.nːa
molo	ˈmɔ.lo
capri	ˈkapri
polvere	ˈpolvere
scatola	ˈskatola
abbaiamento	ab·ba·jaˈmeːn·to
abbattimento	ab.bat.tɨˈmɛːn.to
capelli	kaˈpelli
lumache	luˈmake
lumaca	luˈmaka
manicotti	ma.niˈkɔt̪.t̪i
senape	ˈsɛnape
stivale	st̪iˈvale
coniglio	koˈniʎʎo
coniglia	koˈniʎʎa
coniglietto	koniʎˈʎetto
lepre	ˈlɛpre
rognone	roɲˈɲone
rene	ˈrɛ.ne
broccolo	ˈbrɔk.̚ko.lo
cavolo	ˈka.vo.lo
cetriolo	tʃe.tri.ˈɔ.lo
azzurri	adˈdzurri
ciliegie	tʃ͡iˈljɛː.dʒ͡e
prugna	ˈpruɲɲa
catenaccio	ka.teˈnat.̚tʃo
corretto	korˈrɛtto
cinzano	tʃintsano
all'amatriciana	allamatriˈt͡ʃana
ragù	ra.ˈɡu
narrativo	nar.raˈt̪iː.vo
assieme	as.ˈsjɛ.me
avvento	avˈvɛnto
avvio	av.ˈvi.o
allegria	al.le.ˈɡri.a
troppo	ˈtrɔppo
bastone	basˈtone
blu	blu
botta	ˈbɔtta
botte	ˈbot.te
bozza	ˈbɔttsa
brezza	ˈbreddza
buccia	ˈbuttʃa
bugia	bu.ˈdʒi.a
buzzo	ˈbuddzo
tassì	tasˈsi
caccia	ˈkat.tʃa
calore	ka.ˈlo.re
cammeo	kam.ˈmɛ.o
capace	kaˈpaː.tʃe
casinò	ka.ziˈno
cassa	ˈkas.sa
ceneri	ˈtʃeneri
ceppo	ˈtʃep.po
minchia	ˈminkja
sottile	sotˈtile
ciabatta	tʃaˈbatta
cilindro	t͡ʃi.lin.ˈdrɔ
cinetico	t͡ʃiˈnɛtiko
ciocca	ˈtʃɔkka
cippo	ˈt͡ʃippo
venere	ˈvɛ.ne.re
giove	ˈdʒɔve
nettuno	netˈtuno
plutone	pluˈtone
pesi	ˈpesi
fodero	ˈfo.de.ro
clinica	ˈklinika
cognato	koˈɲɲaː.t̪o
passero	ˈpassero
pinguino	pin.ˈɡwi.no
colpire	kolˈpire
colui	koˈlui
concetto	konˈt͡ʃɛtto
contare	konˈtare
bottiglia	boˈtɪʎʲa
adultere	a.dul.ˈtɛ.re
arbitro	ˈarbitro
elaborare	elaboˈrare
emulo	ˈɛ.mu.lo
emulare	e.muˈla.re
filosofo	fiˈlɔː.zo.fo
filosofa	fiˈlɔː.zo.fa
filosofe	fiˈlɔː.zo.fe
settembre	setˈtɛm.bre
ottobre	otˈtoː.bre
dicembre	diˈtʃɛm.bre
fato	ˈfaː.to
coscia	ˈkɔʃʃa
biologia	bioloˈdʒi.a
torneo	tor.ˈnɛ.o
costui	koˈstui
vomitare	vomiˈtare
assiolo	as.ˈsjɔ.lo
minuendo	minuˈɛndo
crisma	ˈkris.ma
cristo	ˈkriː.st̪o
medici	ˈme.di.tʃi
scarabeo	ska.ra.ˈbɛ.o
passo	ˈpasso
minore	mi.ˈno.re
legare	leˈɡare
scena	ˈʃɛː.na
episteme	e.pi.ˈstɛ.me
crostaceo	kroˈst̪aː.tʃ͡e.o
crusca	ˈkruska
cucina	kuˈtʃina
petto	ˈpɛtto
alcool	al.kɔ.ˈɔl
bugie	bu.ˈdʒi.e
sputare	spuˈtare
fatto	ˈfat.to
facevano	faˈtʃeː.va.no
fecero	ˈfeː.tʃe.ro
farebbero	faˈrebɛro
facciamo	fatˈtʃaː.mo
illudere	ilˈludere
stendere	ˈstɛndere
arancione	a.ranˈtʃo.ne
inquilino	iŋkwiˈlino
coniglietta	koniʎˈʎetta
foglia	ˈfɔʎʎa
ragazzo	raˈɡat.̚tso
ricche	ˈrikke
ricchezza	rikˈkett͡sa
danubio	daˈnubjo
secolo	ˈsɛkolo
giornale	d͡ʒorˈnale
mattino	matˈtino
diurno	di.ˈur.no
gesù	dʒ͡eˈzu
campagna	kamˈpaː.ɲɲa
messia	mesˈsiː.a
malattia	malatˈtia
testicolo	te.ˈsti.ko.lo
fede	ˈfede
museo	mu.ˈzɛ.o
arrivederci	ar.ri.veˈder.tʃi
michelangelo	ˌmi.kel.ˈan.d͡ʒe.lo
odore	o.ˈdo.re
gravitazione	ɡravitaˈtsjone
galassia	ɡaˈlas.sja
unione europea	u.ˈnjo.ne eu.ro.ˈpɛ.a
significato	siɲɲifiˈkato
terremoto	tɛr.rɛ.ˈmɔ.tɔ
polizia	po.liˈtsi.a
carriera	karˈrjɛː.ra
schiena	ˈskjɛna
foglio	ˈfɔʎ.ʎo
asciutto	aʃˈʃutto
asciugare	aʃʃuˈɡare
errore	er.ˈro.re
gianni	ˈdʒanni
follicolo	fol.ˈli.ko.lo
procione	proˈtʃone
infinito	in.fiˈniː.t̪o
ricerca	riˈtʃer.ka
rotondo	roˈtondo
gomma	ˈɡomma
cacciare	katˈtʃare
liscio	ˈliʃʃo
liceo	li.ˈtʃɛ.o
deflagrare	deflaˈɡrare
deflagrate	deflaˈɡrate
sciocco	ˈʃɔk.ko
organizzazione	or.ɡa.nid.dzat.ˈtsjoː.ne
supremo	su.ˈprɛ.mo
combattere	komˈbattere
comunicazione	ko.mu.ni.kaˈtsjoː.ne
pentacolo	pen.ˈta.ko.lo
meglio	ˈmɛ.ʎʎo
svegliare	zveʎˈʎare
capibara	kapiˈbara
invenzione	invɛnˈt͡sjoːne
ormai	orˈmai
diminuire	diminuˈire
remoto	reˈmɔː.t̪o
dritto	dritto
eufemismo	eu.fe.ˈmi.zmo
eufemistico	eu.fe.ˈmi.sti.ko
musiche	ˈmuː.zi.ke
caricare	ka.ri.ˈka.re
girare	dʒiˈrare
giù	d͡ʒu
salante	saˈlante
chiarire	kjaˈriː.re
sporco	ˈspɔrko
magnete	maɲ.ˈɲɛ.te
embrione	em.bri.ˈo.ne
fascismo	faʃˈʃi.zmo
felce	ˈfeltʃe
buone	ˈbwɔː.ne
facili	ˈfaː.tʃi.li
vizio	ˈvitsjo
lardo	ˈlar.dɔ
somma	ˈsomma
pausa	ˈpau.za
europea	eu.ro.ˈpɛ.a
derivazione	derivaˈtsjone
fendere	ˈfɛndere
intelletto	in.tel.ˈlɛt.to
veicolo	ve.ˈi.ko.lo
bocce	ˈbɔttʃe
isolare	i.zoˈlaː.re
pidocchio	pi.ˈdɔk̚.kjo
pidocchioso	pi.ˌdɔk̚.ˈkjo.zo
pagliaccio	paʎˈʎatt͡ʃo
bussola	ˈbussola
diciassette	ditʃasˈsɛtte
lebbra	ˈlebbra
paiolo	pa.ˈjɔ.lo
gigli	ˈdʒiʎʎi
camminata	kam.mi.ˈna.ta
pipistrello	pi.piˈstrɛl.lo
anfibio	anˈfi.bi.o
anch'io	aŋˈkiː.o
amici	a.ˈmi.tʃi
impero	imˈpɛro
diciotto	diˈtʃɔtto
ponti	ˈpon.ti
alcuni	alˈkuni
galassie	ɡaˈlas.sje
particella	par.ti.ˈtʃɛl.la
bagnato	baɲˈɲato
tutta	ˈtutta
cucciolo	ˈkuttʃolo
associazione	asːotʃaˈtsjone
vendita	ˈvendita
ruolo	ˈrwɔ.lo
udienza	uˈdjɛntsa
mezzi	ˈmɛd.dz͡i
mongolfiera	moŋ.gol.'fjɛ.ra
segreteria	seɡreteˈria
vigore	vi.ˈɡo.re
tasso	ˈtasso
fioritura	fjoriˈtura
realizzazione	rea.lid.dzat.ˈtsjo.ne
aliquota	aˈlikwota
pizzico	ˈpittsiko
arcipelago	artʃiˈpɛlaɡo
castagna	ka.ˈstaɲ.ɲa
abbandonò	abbandoˈno
accelera	atˈt͡ʃɛlera
calamita	ka.la.ˈmi.ta
rapi	ˈra.pi
cammino	kam.ˈmi.nɔ
camminò	kam.mi.ˈnɔ
filosofi	fiˈlɔː.zo.fi
guido	ˈɡwi.do
guidò	ɡwi.ˈdo
scusi	ˈskuzi
daniele	da.ˈnjɛ.le
trofeo	tro.ˈfɛ.o
extraeuropeo	ek.stra.eu.ro.ˈpɛ.o
pece	ˈpetʃe
eau	eau
tiroideo	ti.roi.ˈdɛ.o
orrore	or.ˈro.re
tocco	ˈtokko
tocchi	ˈtokki
carriere	karˈrjɛː.re
pipistrelli	pi.piˈstrɛl.li
celiachia	tʃeliaˈkia
agricolo	a.ˈɡri.ko.lo
armonizzare	ar.mo.nidˈdzaː.re
bacino	baˈtʃino
poggio	ˈpɔddʒo
controversia	kon.tro.ˈvɛr.sja
diurne	di.ˈur.ne
banche	ˈbaŋ.ke
rara	ˈraː.ra
rapì	ra.ˈpi
agonia	aɡoˈnia
asilo	aˈzilo
specializzazione	spe.tʃa.lid.dzatˈtsjo.ne
portamento	portaˈmento
affilato	affiˈlato
travaglio	traˈva.ʎːo
addirsi	ad̪.ˈd̪ir.si
frontale	fron.ˈta.le
regalati	re.ɡaˈla.ti
pedone	peˈdone
rumeno	ruˈmɛː.no
schifo	ˈski.fo
nolo	ˈnɔ.lo
amabile	a.ma.bi.le
miscela	miʃˈʃɛla
reticolo	reˈtikolo
suolo	ˈswɔ.lo
indurre	inˈdurre
alfabeti	al.fa.ˈbɛ.ti
anonimità	a.no.ni.miˈta
ventilatore	ven.ti.la.ˈto.re
gnomo	ˈɲomo
pezza	ˈpɛttsa
ununbio	u.num.ˈbi.o
affrettarsi	af.frɛt.ˈtar.si
graffiare	ɡrafˈfjare
manipolo	ma.ˈni.po.lo
alfiere	alˈfjɛre
giogo	ˈdʒoɡo
fabbricazione	fabbrikaˈtsjone
ottone	otˈtone
galleggiare	ɡalledˈdʒare
mazza	ˈmat.tsa
valete	vaˈle.te
sopravvivere	so.praˈvːi.ve.re
chierico	ˈkjɛriko
soggiacere	soddʒaˈtʃere
bersagliere	bersaʎˈʎɛre
fluire	fluˈire
amiche	a.ˈmi.ke
schiarire	skjaˈriː.re
portaerei	portaˈɛrei
esca	ˈeska
pugnalare	puɲɲaˈlare
disdire	d̪iz.ˈd̪iː.re
tribù	triˈbu
sbarra	ˈzbar.ra
lagrima	la.ˈɡri.ma
messere	meˈsːɛ.re
figliolo	fiʎ.ˈʎɔ.lo
inclito	ˈiŋ.kli.t̪o
bestemmiare	be.st̪emˈmjaː.re
manifestazione	ma.ni.fɛ.sta.ˈtːsjɔ.ne
giudeo	dʒu.ˈdɛ.o
caserma	kaˈzɛrma
giubileo	dʒu.bi.ˈlɛ.o
gattara	ɡat.ˈta.ra
sudore	suˈdore
sughero	ˈsuɡero
strofinare	strofiˈnare
brontolio	bron.toˈli.o
soffiare	sofˈfjare
maremoto	ma.re.ˈmo.to
vinicolo	vi.ˈni.ko.lo
scemo	ˈʃemo
sceme	ˈʃe.me
tenue	ˈt̪ɛnɯɛ
viticolo	vi.ˈti.ko.lo
nebbiolo	nebˈbjɔlo
navicella	naviˈt͡ʃɛlla
pallone	pal.ˈlo.ne
pieve	ˈpjɛ.ve
consorzio	konˈsɔrtsjo
svelto	ˈzvɛlto
segretaria	seɡreˈtaria
canaglia	kaˈnaʎa
collera	ˈkɔllera
feccia	ˈfettʃa
parrucca	paˈrːukːa
scavare	skaˈvare
sedici	ˈseditʃi
sfortuna	sforˈtuna
bizzarro	bid.ˈdzar.ro
corteccia	korˈtettʃa
marcio	ˈmartʃo
mentalità	mentaliˈta
moschea	moˈskɛ.a
chierica	ˈkjɛrika
ortografia	ortoɡraˈfia
elaboratore	elaboraˈtore
rozzo	ˈroddzo
scacchi	ˈskakki
schizzo	ˈskitt͡so
scivolo	ˈʃivolo
specchietto	spɛk.kjɛt.to
speme	ˈspɛ.me
tutore	tu.ˈto.re
ci vediamo	ˈtʃi veˈd̪jaː.mo
assioma	asˈsjɔma
gradiente	ɡraˈdjɛnte
antonimo	anˈtɔ.ni.mo
romeno	roˈmɛː.no
luppolo	ˈluppolo
bocciolo	bot.ˈtʃɔ.lo
mollica	mol.ˈli.ka
branchia	ˈbran.kja
vaniglia	vaˈniʎʎa
doppiaggio	dop.ˈpjad.dʒo
fariseo	fa.ri.ˈzɛ.o
murale	muˈra.le
parrucchiere	pa.rːuˈkːjɛ.re
amarena	amaˈrɛna
agopuntura	aɡopunˈtura
ressa	ˈrɛssa
barometro	ba.ˈro.me.tro
diamagnetico	dja.maɲ.ˈɲɛ.ti.ko
abbordaggio	abborˈdaddʒo
dodecaedro	dodekaˈɛdro
lambrusco	lam.ˈbru.sko
lambrusco	lam.ˈbru.sko
tolda	ˈtolda
donnola	dɔnˈnɔla
cursore	kurˈsore
sbadigliare	zba.diʎˈʎaː.re
sbadiglio	zbaˈdiʎ.ʎo
sbarazzare	zba.rat.ˈtsa.re
sguazzare	sɡwatˈtsare
curiosare	ku.rjo.ˈzaː.re
epicureo	e.pi.ku.ˈrɛ.o
lesto	ˈlɛsto
sfregiare	sfreˈd͡ʒare
ventricolo	ven.ˈtri.ko.lo
tirocinio	ti.roˈtʃi.njo
vessillo	vesˈsillo
susina	suˈzi.na
funicolo	fu.ˈni.ko.lo
babbeo	bab.ˈbɛ.o
enfasi	ˈɛɱ.fa.zi
ebete	ˈɛbete
bagarre	baˈɡar
omofono	oˈmɔfono
culatello	kulaˈtɛllo
moschee	moˈskɛ.e
frattanto	frat'tanto
predominio	predoˈminjo
jacuzzi	jaˈkuttsi
galateo	ɡa.la.ˈtɛ.o
androceo	an.dro.ˈtʃɛ.o
manicheo	ma.ni.ˈkɛ.o
gineceo	dʒi.ne.ˈtʃɛ.o
canicola	kaˈnikola
acaro	ˈakaro
gnocco	ˈɲɔkko
eritreo	e.ri.ˈtrɛ.o
ipogeo	i.po.ˈdʒɛ.o
lucciola	ˈluttʃola
vichingo	viˈkinɡo
apogeo	a.po.ˈdʒɛ.o
misantropo	miˈzantropo
marameo	ma.ra.ˈmɛ.o
calzare	kalˈd͡zare
iracondo	iraˈkondo
cestista	tʃeˈstista
sillabazione	sillabaˈtsjone
ateneo	a.te.ˈnɛ.o
angelico	an.ˈdʒɛ.li.ko
tallone	t̪alˈlone
torchio	ˈtɔrkjo
adiposità	a.di.po.zi.ˈta
acquaiolo	ak.kwa.ˈjɔ.lo
dolo	ˈdɔ.lo
fascicolo	faʃ.ˈʃi.ko.lo
ciliege	tʃ͡iˈljɛː.dʒ͡e
collerico	kolˈlɛriko
negligente	negliˈdʒɛnte
barberia	bar.beˈri.a
barcaiolo	bar.ka.ˈjɔ.lo
recedere	reˈtʃɛdere
rione	riˈone
righello	riˈɡɛllo
foschia	foˈskia
montone	monˈtone
agonie	aɡoˈnie
plebeo	ple.ˈbɛ.o
uggia	ˈuddʒa
sgabello	zɡaˈbɛl.̚lo
cunicolo	ku.ˈni.ko.lo
sferza	ˈsfɛrza
guizzo	ˈɡwittso
uditorio	udiˈtɔrjo
rozzezza	rodˈdzettsa
bidonville	bi.dɔn.vil
menisco	meˈnisko
botolo	ˈbɔtolo
esponenziale	esponenˈtsjale
archivista	ar.kiˈvi.sta
armaiolo	ar.ma.ˈjɔ.lo
boscaiolo	bo.ska.ˈjɔ.lo
giaggiolo	dʒadˈdʒɔlo
campanilismo	kam.pa.niˈliz.mo
teleologia	te.le.o.loˈdʒi.a
teleologie	te.le.o.loˈdʒi.e
chiazza	ˈkjattsa
ciano	ˈtʃi.a.no
emulatore	e.mu.laˈto.re
emulatrice	e.mu.la.tri.t͡ʃe
selce	sel.t͡ʃe
perigeo	pe.ri.ˈdʒɛ.o
sgelare	zdʒe.ˈlaː.re
niccolò	nik.koˈlo
sleale	zleˈaː.le
filisteo	fi.li.ˈstɛ.o
stambecco	stamˈbekko
sottoinsieme	sot.to.in.ˈsjɛ.me
bagnolo	baɲ.ˈɲɔ.lo
scaleo	ska.ˈlɛ.o
invariante	in.vaˈrjan.t̪e
cenciaiolo	tʃen.tʃa.ˈjɔ.lo
cenciaioli	tʃen.tʃa.ˈjɔ.li
chiarificazione	kjarifikaˈt͡sjone
circumnavigazione	t͡ʃir.kum.na.vi.ɡa.ˈtsjo.ne
sdrucciola	ˈzdruttʃola
consorziale	kon.sorˈtsja.le
slealtà	zle.alˈt̪a
fati	ˈfaː.ti
festaiolo	fe.sta.ˈjɔ.lo
portogallo	por.t̪oˈɡal.̚lo
rais	raˈis
recedé	retʃeˈde
moschetto	mo.ˈsket.to
risicolo	ri.ˈsi.ko.lo
passe-partout	pasparˈtu
peritoneo	pe.ri.to.ˈnɛ.o
cubicolo	ku.ˈbi.ko.lo
sbobba	ˈsbɔbba
stuolo	ˈstwɔ.lo
berna	ˈberna
avicolo	a.ˈvi.ko.lo
visore	vi.ˈzo.re
eufemisticamente	eu.fe.mi.sti.ka.ˈmen.te
ussaro	ˈussaro
esistenzialismo	e.zi.sten.tsja.ˈli.smo
esistenzialismi	e.zi.sten.tsja.ˈli.smi
piagnisteo	pjaɲ.ɲi.ˈstɛ.o
rucola	ˈrukola
rogito	ˈrɔdʒito
rabberciatura	rabbertʃaˈtura
randello	ranˈdɛllo
sturalavandini	sturalavanˈdini
corifeo	ko.ri.ˈfɛ.o
come ti chiami	ˈkoː.me t̪i ˈkjaː.mi
mi chiamo	ˈmi ˈkjaː.mo
passepartout	pasparˈtu
polireme	po.li.ˈrɛ.me
fibrato	fiˈbrato
putrella	puˈtrɛlla
scautismo	skauˈtizmo
tugurio	tuˈɡurio
magnare	maɲˈɲare
che ora è	ke ˈoː.ra ɛ
che ore sono	ke ˈoː.re ˈsoː.no
eppur si muove	epˈpur si ˈmwɔː.ve
mi manchi	mi ˈmaŋ.ki
indoeuropeo	in.do.eu.ro.ˈpɛ.o
dattilo	ˈdattilo
spondeo	spon.ˈdɛ.o
simplettico	simˈplɛttiko
diffeomorfismo	diffeomorˈfizmo
automorfismo	automorˈfizmo
brachistocrona	brakiˈstɔkrona
emisimmetrico	emisimˈmɛtriko
antisimmetrico	antisimˈmɛtriko
diagonalizzazione	diaɡonaliddzaˈtsjone
culatta	kuˈlatta
epicicloide	epitʃiˈklɔide
sequente	seˈkwɛnte
coomologia	koomoloˈdʒia
compattificazione	kompattifikaˈtsjone
laplaciano	laplaˈtʃano
rettificabile	rettifiˈkabile
jacobiano	jakoˈbjano
omologia	omoloˈdʒia
convoluzione	konvoluˈtsjone
paraconsistente	parakonsiˈstɛnte
funtore	funˈtore
olomorfo	oloˈmɔrfo
sirima	ˈsiː.ri.ma
sirma	ˈsir.ma
valligiano	va.lːi.ˈd͡ʒa.no
flussione	flusˈsjone
tifoideo	ti.foi.ˈdɛ.o
uditore	u.di.ˈto.re
caduceo	ka.du.ˈtʃɛ.o
imeneo	i.me.ˈnɛ.o
granicolo	ɡra.ˈni.ko.lo
antonimia	an.to.niˈmi.a
pantografo	panˈtɔɡrafo
gheiscia	ˈɡɛiʃʃa
barolo	ba.ˈrɔ.lo
lupo di mare	ˌlu.po di ˈma.ɾe
sternocleidomastoideo	ster.no.klei.do.ma.stoi.ˈdɛ.o
controaliseo	kon.tro.a.li.ˈzɛ.o
aliseo	a.li.ˈzɛ.o
duolo	ˈdwɔ.lo
stiavo	ˈstjavo
-esa	ˈe.za
prosciutt	prəˈʃut
adusto	a.ˈdus.to
panatenee	pa.na.teˈnɛ.e
pannicolo	pan.ˈni.ko.lo
asclepiadeo	a.skle.pja.ˈdɛ.o
cenciaiola	tʃen.tʃa.ˈjɔ.la
biciclettata	bi.t͡ʃi.kleˈtːa.ta
icore	i.ˈko.re
ubbia	ub.ˈbi.a
quadrigato	kwadriˈɡato
dipsomane	dipˈsɔ.ma.ne
messer	meˈsːɛ.r
pinzimonio	pin.t͡si.ˈmɔː.njo
sinfonietta	sinfoniˈɛtːa
entelechia	en.te.leˈki.a
entelechie	en.te.leˈki.e
more uxorio	ˌmɔ.re.ukˈsɔ.rjo
-aglia	ˈaʎːa
mattonata	mat.to.ˈna.ta
loro	ˈloro
trullo	ˈtrullo
cenciaiole	tʃen.tʃa.ˈjɔ.le
water	ˈvater
etruscheria	e.trus.ke.ˈri.a
violaciocca	vi.o.la.ˈtʃɔk.ka
convalligiano	kon.va.lːi.ˈd͡ʒa.no
muramento	mu.raˈmen.to
